**************11**************
*----------------------------*
*----------------------------*
*----------------------------*
*----------------------------*
*----------------------------*
*----------------------------*
*----------------------------*
*----------------------------*
*----------------------------*
*----------------------------*
*----------------------------*
*----------------------------*
*----------------------------*
*----------------------------*
*----------------------------*
**************3***************