**************1***************
*----------------------------*
*----------------------------*
*----------------------------*
*----------------------------*
*----------------------------*
*----------------------------*
*----------------------------*
*----------------------------*
*----------------------------*
*----------------------------*
*----------------------------*
*----------------------------*
*----------------------------*
*----------------------------*
*----------------------------*
**************3***************