**************11**************
*----------------------------*
*----------------------------*
*----------------------------*
*----------------------------*
*----------------------------*
*----------------------------*
*----------------------------*
*----------------------------*
*----------------------------*
*----------------------------*
*----------------------------*
*----------------------------*
*----------------------------*
*----------------------------*
**************33**************
