**************1***************
*----------------------------*
*----------------------------*
*----------------------------*
*----------------------------*
*----------------------------*
*----------------------------*
*----------------------------*
*----------------------------*
*----------------------------*
*----------------------------*
*----------------------------*
*----------------------------*
*----------------------------*
*----------------------------*
*----------------------------*
******************************