******************************
*----------------------------*
*-----------------r----------*
*----------------------------*
*----------------------------*
*---------**********---------*
*---------*--------*---------*
*----m----*--------*---------2
*---------*--------*---------2
*---------*--------*----m----*
*---------*--------*---------*
*---------*--------*---------*
*---------**********---------*
*----------------------------*
*----------------------------*
**************00**************