******************************
*----------------------------*
*----------------------------*
*----------------------------*
*----------------------------*
*---------**********---------*
*---------*--------*---------*
*---------*--------*---------2
*---------*--------*---------2
*---------*--------*---------*
*---------*--------*---------*
*---------*--------*---------*
*---------**********---------*
*----------------------------*
*----------------------------*
**************00**************