******************************
*----------------------------*
*----------------------------*
*----------------------------*
*----------------------------*
*---------**********---------*
*---------*--------*---------*
*---------*--------*---------*
*---------*--------*---------*
*---------*--------*---------*
*---------*--------*---------*
*---------*--------*---------*
*---------**********---------*
*----------------------------*
*----------------------------*
*----------------------------*
**************0***************