**************0***************
*----------------------------*
*----------------------------*
*----------------------------*
*----------------------------*
*---------**********---------*
*---------*--------*---------*
*---------*--------*---------*
*---------*--------*---------*
*---------*--------*---------*
*---------*--------*---------*
*---------*--------*---------*
*---------**********---------*
*----------------------------*
*----------------------------*
*----------------------------*
******************************